1111111111111111111111111
11111111111CC111111111111
1111111111C00C11111111111
1111111110011001111111111
111111110C0C00C0111111111
11111110C1111110011111111
111111P011111111CE1111111
1111111111111111111111111