111111111111111111111111111111111111
1P0000000000000C000000000C0000000001
101111110000111110001111100111110B01
100000010B001000000B00001000B0100011
100C001B1000010111111111010000100001
1000000100B01000000000C0100000000011
100111110000111111111000111111100001
1001000000000000B0001000000000B00001
100100111111110001001111111111110001
100B000000000C01001000000000000B0001
100001111100001010001111110001111101
100B0C00100001B101000000000100000001
111110111100001111100001111100111101
10000000000B00000010000000C000000E11
111111111111111111111111111111111111