111111111111111111111111111111
111100011110000000011011000001
1P00E0000000010000B01000001101
111000000100000000000011110001
100000000101011000000000000101
100000000100000000000001100001
1000B0000001000000CB0000000001
100000000000B00000000000000001
111111111111111111111111111111