111111111111111111111111111111
110000011110000000011011000001
1P0C0E000000010000B01000001101
100000000100000000000011110001
100000000101011000000000000101
1000000001000000000000011C0001
1000B00000010000000B0000000001
100000000000B00000000000000001
111111111111111111111111111111