1111111111111111111111
1BBBBBBBBBBBBBBBBBBBB1
1BBBBBBB0000BBBBBBBBB1
1BBBBBB00BBC0BBBBBBBB1
1BBBBB00BBBB00BBBBBBB1
1BBBB0000BB00C0BBBBBB1
1BBB00BBBBBBBB00BBBBB1
1BBP0BBBBBBBBBB0EBBBB1
1111111111111111111111