11111111111111111111111111111111111111111111111111111111111
10000001111000000001101100000000000011110000000011011000001
10C0000000001E0000B010000011000000000000010000B010000001101
10000000010000000000001111000000000000100000000000011110001
10000000010101100000000000010000000000101000000000000000101
1000000001000000000000011C000000000000101000000000000000101
1000B00000010000000B000000000000000000101000000000000000101
100000000000B0000000000000000000000000101000000000000000101
10000001111000000001101100000000000000101011000000000000101
100C00000000010000B0100000110000000000101011000000000000101
10000000010000000000001111000000000000101011000000000000101
10000000010101100000000000010000000000101011000000000000101
1000000001000000000000011C000000000000101011000000000000101
1000B00000010000000B000000000000000000101011000000000000101
100000000000B0000000000000000000000000101011000000000000101
10000001111000000001101100000000000000101011000000000000101
1P0C00000000010000B0100000110000000000101011000000000000101
10000000010000000000001111000000000000101011000000000000101
10000000010101100000000000010000000000101011000000000000101
1000000001000000000000011C000000000000101011000000000000101
1000B00000010000000B000000000000000000101011000000000000101
100000000000B0000000000000000000000000101011000000000000101
11111111111111111111111111111111111111111111111111111111111