111111111111111111111111111111111111111111111111111111111111
1P0000000000000000000000000000000000000000000000000000000001
101111110000111110001111100111110001111100011111000111110B01
1000000100001000000B00001000001000100000001000B0001000000001
100C001010000101111111110100001000011100010111111100C0000001
1000000100001000000000C0100000000010000100000000000000B00001
100111110000111111111000111111100001011110000111111111110001
1001000000000000000010000000000000010000B0000100000000000001
1001001111111100010011111111111100B10111111101000C0000000001
100B000000000C01001000000000000B0001000000101000011111111101
100001111100001010001111110001111101100001000100001000B00001
10000C00100001B10100B000000100000001000000000000000000000001
101110111111111011110001111111111100011111111111111110001111
100000000000000000100000000000000000000000000000000000000001
111111110001111100011111111111110000111111111111100111111101
10000000000000B000000000000000000000B000B00000000000B0000001
100011111111111111100000111110000B000000000000C0000000000001
100000000000000001000000000000000001111111111111100000000001
101111111111111101111000000B00000001000000000000000111111111
100011111111111111100001111111111111111110001111000111111101
10000000000000B0000000010000000B00C0000000000000000000000001
101111111100011111100011111110000111111111111000011111100001
100000000000000000000000000000000000000000000000000000000001
1000000011111111000001111111100B0111100000C00000000000000001
1000000000000000000000000000B0000001111111100001111111111101
100000000000C00000000C00000000000000000000010000C00000000E11
101111111111111111110000111111100001111111111100011111100001
100000000B000000000000000000B0000000000000000000000000000001
100011111111111111100001111111111111111110001111000111111101
10000B000000000000000000000C00000000000C00000000000000000001
100000000001111111111111111100000000000000011111111111100001
111111111111111111111111111111111111111111111111111111111111