11111
1PC11
110E1
11111
11111
11111